NO textures/NO.xpm
SO textures/SO.xpm
WE textures/WE.xpm
EA textures/EA.xpm
F 80, 75, 61
C 165, 176, 196

         1111111 11111111111111111111    11111111111   11111111111111111111111111111111111111111111111111111111111111
    111111000001110000000000000000001    10000000001   10000000000000000000000000000000001111111111111111111111111111
1111100000000000000000000000000000001    10000000001   10000000000000000000000000000000000000000000000000000000000001
1000000000000000000000011111111111111    10000000001   10000000000000000000000000000000000000000000000000000000000001111
1000000000000000000000011111111111111111110000000001   10000000000000000000000000000000001111111100000000000000000000001
100000000000000000000001111111111111111111000000000111110000000000000000000000000000000001      100000000000000000000001
100000000000000000000000000000000000000000000000000000000000000000000000000000000000000001      111111111111000000000001
100000000000000000111100000000000000000000000000000000000000000000000000000000000000000001                 1000000000001
1000000000000000001  100000000000000000000000000000000000000000000000000000000000011111111                 1000000000001
100000000000000000111100000000000000000000000000000000000000000000000000000000000011111111111111111111111  1000000000001
100000100000000000000000000000000000000000000000000000000000000000000000000000000011111111111111111111111  1000000000001
110000100000011111100000000000000000000000000000000000000000000000000000000000000000000000000000000000001  1000000000001
 10000100000011  1100000000000000000000000000000000000000000000000000000000000000000000000000000000000001  1000000000001
110000100000011  1100000000000000000000000000000000000000000000000000000000000000000000000000000000000001  1000000000001
100000100000011111100000000000000000000000000000000000000000000000000000000000000000000000000000000000001  1000000000001
100000000000000000000000000000000000000000000000000000000000000000000000000000000011111111111111111111111  1000000000001
100000000000000000000000001111111111111111111111111111111111111111111111111111111111111111111111111111111  1000000000001
10000000000000000000000000111111111111111111111111111111111111111111111111111111111                        1000000000001
100000000000000000000000001111111111111111111111111111111111111111111111111111111111111111111111111111111111000000000001
100000000001110000000000000000000000000000000000000000000000000000000000000000000000000000000000000000000000000000000001
100011110001 10000000000000000000000000000000000000000000000000000000000000000000000000000000000000000000000000000000001
11111  10001 10000000000000000000000000000000000000000000000000000000000000000000000000000000000000000000000000000000001
       11111 11111111111111111111111111111111111111111111111111111111111111111111111111111111111111111111111111111111111